20 20
1 1 1 1 1 1 1 1 1 1 1 1 1 1 1 1 1 1 1 1 
1 7 7 7 7 7 7 7 7 7 7 7 7 7 7 7 7 7 7 1 
1 6 0 0 0 0 0 0 0 0 0 0 0 0 0 0 0 0 5 1 
1 6 0 0 0 0 0 0 0 0 0 0 0 0 0 0 0 0 5 1 
1 6 0 0 0 0 0 0 0 0 0 0 0 0 0 0 0 0 5 1 
1 6 0 0 0 0 0 0 0 0 0 0 0 0 0 0 0 0 5 1 
1 6 0 0 0 0 0 0 0 0 0 0 0 0 0 0 0 0 5 1 
1 6 0 0 0 0 0 0 0 0 0 0 0 0 0 0 0 0 5 1 
1 2 2 2 2 4 0 0 3 2 2 2 2 2 2 2 2 2 2 1 
1 7 7 7 7 9 0 0 8 7 7 7 7 7 7 7 7 7 7 1 
1 6 0 0 0 0 0 0 0 0 0 0 0 0 0 0 0 0 5 1 
1 6 0 0 0 3 2 2 4 0 0 0 0 0 0 0 0 0 5 1 
1 6 0 0 0 8 7 7 9 0 0 0 0 0 0 0 0 0 5 1 
1 6 0 0 0 0 0 0 0 0 0 3 2 2 2 2 4 0 5 1 
1 6 0 0 0 0 0 0 0 0 0 8 7 7 7 7 9 0 5 1 
1 6 0 0 0 0 0 0 3 2 4 0 0 0 0 0 0 0 5 1 
1 6 0 0 0 0 0 0 8 7 9 0 0 0 0 0 0 0 5 1 
1 6 0 0 3 2 2 4 0 0 0 0 0 0 0 0 0 0 5 1 
1 6 0 0 8 7 7 9 0 0 0 0 0 0 0 0 0 0 5 1 
1 2 2 2 2 2 2 2 2 2 2 2 2 2 2 2 2 2 2 1 

1 1 1 1 1 1 1 1 1 1 1 1 1 1 1 1 1 1 1 1 
1 0 0 0 0 0 0 0 0 0 0 0 0 0 0 0 0 0 0 1 
1 0 0 0 0 0 0 0 0 0 0 0 0 0 0 0 0 0 0 1 
1 0 0 0 0 0 0 0 0 0 0 0 0 0 0 0 0 0 0 1 
1 0 0 0 0 0 0 0 0 0 0 0 0 0 0 0 0 0 0 1 
1 0 0 0 0 0 0 0 0 0 0 0 0 0 0 0 0 0 0 1 
1 0 0 0 0 0 0 0 0 0 0 0 0 0 0 0 0 0 0 1 
1 0 0 0 0 0 0 0 0 0 0 0 0 0 0 0 0 0 0 1 
1 1 1 1 1 0 0 0 0 1 1 1 1 1 1 1 1 1 1 1 
1 0 0 0 0 0 0 0 0 0 0 0 0 0 0 0 0 0 0 1 
1 0 0 0 0 0 0 0 0 0 0 0 0 0 0 0 0 0 0 1 
1 0 0 0 0 0 1 1 0 0 0 0 0 0 0 0 0 0 0 1 
1 0 0 0 0 0 0 0 0 0 0 0 0 0 0 0 0 0 0 1 
1 0 0 0 0 0 0 0 0 0 0 0 1 1 1 1 0 0 0 1 
1 0 0 0 0 0 0 0 0 0 0 0 0 0 0 0 0 0 0 1 
1 0 0 0 0 0 0 0 0 1 0 0 0 0 0 0 0 0 0 1 
1 0 0 0 0 0 0 0 0 0 0 0 0 0 0 0 0 0 0 1 
1 0 0 0 0 1 1 0 0 0 0 0 0 0 0 0 0 0 0 1 
1 0 0 0 0 0 0 0 0 0 0 0 0 0 0 0 0 0 0 1 
1 1 1 1 1 1 1 1 1 1 1 1 1 1 1 1 1 1 1 1 

0 0 0 0 0 0 0 0 0 0 0 0 0 0 0 0 0 0 0 0 
0 0 0 0 0 0 0 0 0 0 0 0 0 0 0 0 0 0 0 0 
0 0 0 0 0 0 0 0 0 0 0 0 0 0 0 0 0 0 0 0 
0 0 0 0 0 0 0 0 0 0 0 0 0 0 0 0 0 0 0 0 
0 0 0 0 0 0 0 0 0 0 0 0 0 0 0 0 0 0 0 0 
0 0 0 0 0 0 0 0 0 0 0 0 0 0 0 0 0 0 0 0 
0 0 0 0 0 0 0 0 0 0 0 0 0 0 0 0 0 0 0 0 
0 0 0 0 0 0 0 0 0 0 0 0 0 1 0 0 0 1 0 0 
0 0 0 0 0 0 0 0 0 0 0 0 0 0 0 0 0 0 0 0 
0 0 0 0 0 0 0 0 0 0 0 0 0 0 0 0 0 0 0 0 
0 0 0 0 0 0 0 0 0 0 0 0 0 0 0 0 0 0 0 0 
0 0 0 0 0 0 0 0 0 0 0 0 0 0 0 0 0 0 0 0 
0 0 0 0 0 0 0 0 0 0 0 0 0 0 2 0 0 0 0 0 
0 0 0 0 0 0 0 0 0 0 0 0 0 0 0 0 0 0 0 0 
0 0 0 0 0 0 0 0 0 0 0 0 0 0 0 0 0 0 0 0 
0 0 0 0 0 0 0 0 0 0 0 0 0 0 0 0 0 0 0 0 
0 0 0 0 0 0 0 0 0 0 0 0 0 0 0 0 0 0 0 0 
0 0 0 0 0 0 0 0 0 0 0 0 0 0 0 0 0 0 0 0 
0 0 0 0 0 0 0 0 0 0 0 0 0 0 0 0 0 0 0 0 
0 0 0 0 0 0 0 0 0 0 0 0 0 0 0 0 0 0 0 0 
